{20, 20, 20, 20, 20, 20, 20, 20, 20,
 60, 60, 60,
 100, 100, 100, 100, 100, 100, 100, 100, 100,
 140, 140,
 180, 180, 180, 180, 180, 180, 180, 180, 180,
 220, 220, 220, 220,
 260, 260, 260, 260, 260, 260, 260, 260, 260,
 300, 300, 300,
 340, 340, 340, 340, 340, 340, 340, 340, 340,
 380, 380,
 420, 420, 420, 420, 420, 420, 420, 420, 420, 420,
 460, 460,
 500, 500, 500, 500, 500, 500, 500, 500, 500, 500,
 540, 540, 540,
 580, 580, 580, 580, 580, 580, 580,
 620, 620, 620, 620,
 660, 660, 660, 660, 660, 660, 660, 660,
 700, 700, 700, 700, 700,
 740, 740, 740, 740, 740, 740, 740, 740,
 780, 780}


{20, 60, 100, 180, 260, 300, 340, 380, 420,
 180, 260, 340,
 20, 60, 100, 180, 220, 260, 340, 380, 420,
 100, 420,
 20, 100, 140, 180, 260, 300, 340, 420, 460,
 20, 100, 180, 340,
 20, 100, 180, 220, 260, 300, 340, 380, 420,
 20, 100, 420,
 20, 100, 140, 180, 260, 300, 340, 380, 420,
 20, 180,
 20, 100, 140, 180, 260, 300, 340, 380, 420, 460,
 100, 260,
 20, 60, 100, 140, 180, 260, 300, 340, 420, 460
 180, 340, 420,
 20, 60, 100, 180, 220, 260, 340,
 20, 100, 260, 340,
 20, 100, 180, 220, 260, 340, 380, 420,
 20, 100, 180, 260, 420,
 20, 100, 180, 260, 300, 340, 420, 460,
 100, 180}
 
 
 
 
 