39 22
222222222222222222522222222222222222222
210000111000011111411111000000110111012
210110100000000011000000010110000001012
210001101000011011011111010110111011012
210111101010111011000111000110111000002
210000001110001011010011011110111011112
200111100000101011011001111110111011112
210111111110101011011101111000000000112
210000001110100000011100000011110110112
200111101110101010111111011110110110102
211111101111101010000000011110110110002
210000001111101011111011011110110110102
210111101110000000011011111110110110002
210011101100001111011011000000000110112
211000001101101111011011111011111110112
211011111101100000000000000000011110112
200011000101111011111111110111011110112
211011010101111011110001100111011110112
211000010100000001100101101111011110112
211101011101101101101001101100011110112
211101000001100001131000001111000000112
222222222222222222222222222222222222222