39 22 45000
222222222222222222222222222222222222222
231000001000100010001000100000000000005
201001101010101010101010101010111140112
201101100010001000100010001000011110112
201101111111111111111111111110011110112
201101111000111100111111110011000000112
200000000000111100111111110011111110112
201110111101100000000000000000011110112
200110011101100000000000111111011110112
210111011101100000000000111111011110112
210000011101111111111110111111011110112
211111111101111111011110111111011110112
211111000000000011011100000001011110112
211111111101111011011100000001000000112
211100000001111011011100000001111110112
201101111111111000000000000001111110112
201101000000000011111100000001111110112
201101011111111111111100000001111110112
201101010000000000001100000000001110112
201101011111111111101111111111101110112
200001000000000000001111111111100000112
222222222222222222222222222222222222222