22 9
1111111111111111111111
1111111000000001111111
1111111010000101111111
1000111000000001110001
1020000000110000000301
1000111000000001110001
1111111010000101111111
1111111000000001111111
1111111111111111111111