39 22
111111111111111111311111111111111111111
110000111000011111011111000000110111011
110110100000000011000000010110000001011
110001101000011011011111010110111011011
110111101010111011000111000110111000001
110000001110001011010011011110111011111
100111100000101011011001111110111011111
110111111110101011011101111000000000111
110000001110100000011100000011110110111
100111101110101010111111011110110110101
111111101111101010000000011110110110001
110000001111101011111011011110110110101
110111101110000000011011111110110110001
110011101100001111011011000000000110111
111000001101101111011011111011111110111
111011111101100000000000000000011110111
100011000101111011111111110111011110111
111011010101111011110001100111011110111
111000010100000001100101101111011110111
111101011101101101101001101100011110111
111101000001100001101000001111000000111
111111111111111111121111111111111111111