39 22
121111111111111111111111111111111111111
101000001000100010001000100000000000003
101001101010101010101010101010111110111
101101100010001000100010001000011110111
101101111111111111111111111110011110111
101101111000111100111111110011000000111
100000000000111100111111110011111110111
101110111101100000000000000000011110111
100110011101100000000000111111011110111
110111011101100000000000111111011110111
110000011101111111111110111111011110111
111111111101111111011110111111011110111
111111000000000011011100000001011110111
111111111101111011011100000001000000111
111100000001111011011100000001111110111
101101111111111000000000000001111110111
101101000000000011111100000001111110111
101101011111111111111100000001111110111
101101010000000000001100000000001110111
101101011111111111101111111111101110111
100001000000000000001111111111100000111
111111111111111111111111111111111111111