39 22 60000
222222222222222222222222222222222222222
211111000000000000001111100000000000002
231111100000000000011111110000000000002
200111110000000000111111111000000000012
200011111000000001111101111100000000112
200001111100000011111000111110000001112
200000111110000111110000011111000011112
200000011111001111100000001111100111112
200000001111111111000000000111111111102
200000000111111110000000000011111111002
200000000011111100000000000001111110002
200000000011111100000000000001111110005
200000000111111110000000000011111111002
200000001111111111000000000111111111102
200000011111001111100000001111100111112
200000111110000111110000011411000011112
200001111100000011111000111110000001112
200011111000000001111101111100000000112
200111110000000000111111111000000000012
201111100000000000011111110000000000002
211111000000000000001111100000000000002
222222222222222222222222222222222222222
