39 22 45000
222222222222222222222222222222222222222
230000000000001111111111111110000000002
200000000000001111111111111100000000002
200000000000001110000000000000000000002
200000000000001110000000000000000000002
200000000000001111111100000000000000002
200000000000001111111000000000000000002
200000000000001110000000000000000000002
200000000000001110000000000000000000002
200000000000001110000000000000000000002
200000000000001110000000000000000000002
211111111111111111111111111111111111112
211111111111111111000000011111111111112
211111111111111000000011111111111111112
211111111111100000001111111111111111112
211111111111000000111111111111111111112
211111111111110000001111111111111111112
211111111111111100000011111111111111112
211111111111110000000111111111111111412
211111111111000000011111111111111111112
211111111000000011111111111111111111112
222222222222222222225222222222222222222
