39 22
222222222222222222222222222222222222222
230111110111011101110111011111111111145
210110010101010101010101010101000001002
210010011101110111011101110111100001002
210010000000000000000000000001100001002
210010000111000011000000001100111111002
211111111111000011000000001100000001002
210001000010011111111111111111100001002
211001100010011111111111000000100001002
201000100010011111111111000000100001002
201111100010000000000001000000100001002
200000000010000000100001000000100001002
200000111111111100100011111110100001002
200000000010000100100011111110111111002
200011111110000100100011111110000001002
210010000000000111111111111110000001002
210010111111111100000011111110000001002
210010100000000000000011111110000001002
210010101111111111110011111111110001002
210010100000000000010000000000010001002
211110111111111111110000000000011111002
222222222222222222222222222222222222222