22 9
2222222222222222222222
2111111000000001111112
2111111010000101111112
2000111000000001110002
2030000000110000000402
2000111000000001110002
2111111010000101111112
2111111000000001111112
2222222222222222222222