39 22 90000
222222222222222222222222222222222222222
213101010101010101010101010101010101012
201010101010101010101010101010101010102
210101010101010101010101010101010101012
201010101010101010101010101010101010102
210101010101010101010101010101010101012
201010101010101010101010101010101010102
210101010101010101010101010101010101012
201010101010101010101010101010101010102
210101010101010101010101010101010101012
201010101010101010101010101010101010102
210101010101010101010101010101010101012
201010101010101010101010101010101010102
210101010101010101010101010101010101012
201010101010101010101010101010101010102
210101010101010101010101040101010101012
201010101010101010101010101010101010102
210101010101010101010101010101010101012
201010101010101010101010101010101010102
210101010101010101010101010101010101012
201010101010101010101010101010101010105
222222222222222222222222222222222222222