39 22 45000
222222222222222222222222222222222222222
230000111111111111110000011111111111112
210000011111111111100000001111111111112
211000001111111111000000000111111111102
211100000111111110000010000011111111002
211110000011111100000111000001111110002
211111000001111000001111100000111100002
211111100000110000011111110000011000002
211111110000000000111111111000000000012
211111111000000001111111111100000000112
211111111100000011111111111110000001112
211111111100000011111111111110000001115
211111111000000001111111111100000000112
211111110000000000111111111000000000012
211111100000110000011111110000011000002
211111000001111000001111100000111100002
211110000011111100000111000001411110002
211100000111111110000010000011111111002
211000001111111111000000000111111111102
210000011111111111100000001111111111112
200000111111111111110000011111111111112
222222222222222222222222222222222222222
