39 22 90000
222222222222222222222222222222222222222
211111111111111111111111111111111111115
210101010101010101010101010101010104012
211111111111111111111111111111111111112
210101010101010101010101010101010101012
211111111111111111111111111111111111112
210101010101010101010101010101010101012
211111111111111111111111111111111111112
210101010101010101010101010101010101012
211111111111111111111111111111111111112
213101010101010101010101010101010101012
211111111111111111111111111111111111112
210101010101010101010101010101010101012
211111111111111111111111111111111111112
210101010101010101010101010101010101012
211111111111111111111111111111111111112
210101010101010101010101010101010101012
211111111111111111111111111111111111112
210101010101010101010101010101010101012
211111111111111111111111111111111111112
210101010101010101010101010101010101012
222222222222222222222222222222222222222