39 22
111111111111111111111111111111111111111
130000011111111111111110111111111111111
101111111111111111111110111111111111111
101111011001000001111110111111111111111
100000010100111001110000111111111111111
101111001110000011100110111111111111111
101111011110111111001110111111111111111
101111011110000000000000111111111111111
111111111111111111111111111111111111111
111111111111111111111111111111111111111
114011111111110011100111100000001111111
110000011110000011100011111111001111111
110010011110010011001001111100011111111
110010011110010010011100111000111111111
110010001100010010000000000000000001111
110011001100110000111110011101111111111
110011001100110000111110011100000001111
110011100001110000111110011101111111111
110011100001110000111110011100000001111
111111111111111111111111111111111111111
111111111111111111111111111111111111111
111111111111111111111111111111111111111
